Thousand
Million
Billion
Trillion
Quadrillion
Quintillion
Sextillion	Thousand trillion	Trilliard	Z	Zetta-
Septillion	Quadrillion	Quadrillion	Y	Yotta-
Octillion	Thousand quadrillion	Quadrilliard
Nonillion	Quintillion	Quintillion
Decillion	Thousand quintillion	Quintilliard
Undecillion	Sextillion	Sextillion
Duodecillion	Thousand sextillion	Sextilliard
Tredecillion	Septillion	Septillion
Quattuordecillion	Thousand septillion	Septilliard
Quindecillion	Octillion	Octillion
Sedecillion	Thousand octillion	Octilliard
Septendecillion	Nonillion	Nonillion
Octodecillion	Thousand nonillion	Nonilliard
Novendecillion	Decillion	Decillion
Vigintillion	Thousand decillion	Decilliard
Unvigintillion	Undecillion	Undecillion
Duovigintillion	Thousand undecillion	Undecilliard
Tresvigintillion	Duodecillion	Duodecillion
Quattuorvigintillion	Thousand duodecillion	Duodecilliard
Quinvigintillion	Tredecillion	Tredecillion
Sesvigintillion	Thousand tredecillion	Tredecilliard
Septemvigintillion	Quattuordecillion	Quattuordecillion
Octovigintillion	Thousand quattuordecillion	Quattuordecilliard
Novemvigintillion	Quindecillion	Quindecillion
Trigintillion	Thousand quindecillion	Quindecilliard
Untrigintillion	Sedecillion	Sedecillion
Duotrigintillion	Thousand sedecillion	Sedecilliard
Trestrigintillion	Septendecillion	Septendecillion
Quattuortrigintillion	Thousand septendecillion	Septendecilliard
Quintrigintillion	Octodecillion	Octodecillion
Sestrigintillion	Thousand octodecillion	Octodecilliard
Septentrigintillion	Novendecillion	Novendecillion
Octotrigintillion	Thousand novendecillion	Novendecilliard
Noventrigintillion	Vigintillion	Vigintillion
Quadragintillion	Thousand vigintillion	Vigintilliard
Quinquagintillion	Thousand quinvigintillion	Quinvigintilliard
Sexagintillion	Thousand trigintillion	Trigintilliard
Septuagintillion	Thousand quintrigintillion	Quintrigintilliard
Octogintillion	Thousand quadragintillion	Quadragintilliard
Nonagintillion	Thousand quinquadragintillion	Quinquadragintilliard
Centillion	Thousand quinquagintillion	Quinquagintilliard
Uncentillion	Unquinquagintillion	Unquinquagintillion
Decicentillion	Thousand quinquinquagintillion	Quinquinquagintilliard
Undecicentillion	Sesquinquagintillion	Sesquinquagintillion
Viginticentillion	Thousand sexagintillion	Sexagintilliard
Unviginticentillion	Unsexagintillion	Unsexagintillion
Trigintacentillion	Thousand quinsexagintillion	Quinsexagintilliard
Quadragintacentillion	Thousand septuagintillion	Septuagintilliard
Quinquagintacentillion	Thousand quinseptuagintillion	Quinseptuagintilliard
Sexagintacentillion	Thousand octogintillion	Octogintilliard
Septuagintacentillion	Thousand quinoctogintillion	Quinoctogintilliard
Octogintacentillion	Thousand nonagintillion	Nonagintilliard
Nonagintacentillion	Thousand quinnonagintillion	Quinnonagintilliard
Ducentillion	Thousand centillion	Centilliard
Trecentillion	Thousand quinquagintacentillion	Quinquagintacentilliard
Quadringentillion	Thousand ducentillion	Ducentilliard
Quingentillion	Thousand quinquagintaducentillion	Quinquagintaducentilliard
Sescentillion	Thousand trecentillion	Trecentilliard
Septingentillion	Thousand quinquagintatrecentillion	Quinquagintatrecentilliard
Octingentillion	Thousand quadringentillion	Quadringentilliard
Nongentillion	Thousand quinquagintaquadringentillion	Quinquagintaquadringentilliard
Millinillion	Thousand quingentillion	Quingentilliard